%%%%%%%
%    P%
% %%% %
%  %. %
%%   %%
%  %%%%
%%%%%%%
