%%%%%%%%%%%%%%%%%%%%%%%%%%%%%%%%%%%%
% .                               P%
% %%%%%%%%%%%%%%%%%%%%%%% %%%%%%%% %
% %%   %   %       %%%%%%%   %%    %
% %% % % % % %%%% %%%%%%%%% %% %%%%%
% %% % % % %             %% %%     %
% %% % % % % % %%%%  %%%    %%%%%% %
% %  % % %   %    %% %%%%%%%%      % 
% %% % % %%%%%%%% %%        %% %%%%%
% %% %   %%       %%%%%%%%% %%     %
% ..   %%%%% %%%%%%%     %% %%%%%% %
%%%%%%                   %% %      %
%      %  %%% %%%%% %    %% %% %%%%%
% %%%%%%      %       %%%%% %%   . %
%        %%  %% %%%%%%%%%%% %%  %% %
%%%%%%%%%%                  %%%%%% %
%          %%%%%%%%%%%%%%%%     .  %
%%%%%%%%%%%%%%%%%%%%%%%%%%%%%%%%%%%%