%%%%%%%%%%%%%%%%%%%%%%
% %%        % %    P %
%                    %
%%%%%%%  %    %%%%%% %
%   .       %%       %
%%%%%%%%%%%%%%%%%%%%%%