%%%%%%%%%%%%%%%%%%%%%%
% %%        % %    P %
%                    %
%%%%%%%  %    %%%%%% %
%   .       %%  . .  %
%%%%%%%%%%%%%%%%%%%%%%