%%%%%%%%%%%%%%%%%%%%%%
% %%        % %    . %
%    %%%%%% % %%%%%% %
%%%%%%     P  %      %
%    % %%%%%% %% %%%%%
% %%%% %         %   %
%        %%% %%%   % %
%%%%%%%%%%    %%%%%% %
%          %%        %
%%%%%%%%%%%%%%%%%%%%%%