%%%%%%%
%    P%
% %%% %
%  %  %
%% . %%
% .%%%%
%%%%%%%
