%%%%%%
%   P%
% %% %
%   .%
%%%%%%
