%%%%%%%
%    P%
% %%% %
%  % .%
%%   %%
%.  %%%
%%%%%%%